77777777777777777
90000000000000008
90000000000000008
90000000000000008
90000000000000008
90000000000000008
90000000000000008
90000002100000008
90000000000000008
90000000000000008
90000000000000008
90000000000000008
90000000000000008
90000000000000008
66666666666666666