77777777777777777
90000000000000008
90122102101010108
90000002000000008
90101012101000108
90020002000222008
90100102201212108
90220002200000008
90221000101010108
90000000000000008
90101010101010108
90000200020002008
90101010101010108
90020000200000028
66666666666666666